##----##############
#                  +
#   ##|||||#####   -
#              +   |
#  #######     #   #
#     #        #   #
#     ###  ##      #
#         #        #
#    ########+++++##
